++++++++++++++++
+              +
+              +
+   +++++++++  +
+   +++++++++  +
+   +++++++++  +
+   +++++++++  +
+   +++++++++  +
+   ++++++++   +
+   ++++++++   +
+   ++++++++   +
+   ++++++++   +
+   ++++++++   +
+              +
+  +++++++++   +
+  +++++++++   +
+  +++++++++   +
+  +++++++++   +
+  +++++++++   +
+  +++++++++   +
+              +
+  +++++++++   +
+  +++++++++   +
+  +++++++++   +
+  +++++++++   +
+  +++++++++   +
+              +
+              +
+              +
++++++++++++++++
