+++++++++E++++++
+              +
+              +
+              +
+      ++   ++++
+      ++   ++++
+           ++++
S           ++++
+           ++++
+           ++++
+      S    ++++
++++++++++++++++
